APPLE	AE P AH L
BACKWARD	B AE K W ER D
BLUE	B L UW
BRIGHTER	B R AY T ER
BUTTON	B AH T AH N
CANCEL	K AE N S AH L
CHANGE	CH EY N JH
CHANNEL	CH AE N AH L
CIRCLE	S ER K AH L
DARKER	D AA R K ER
DOWN	D AW N
EIGHT	EY T
ENTER	EH N T ER
ENTER(2)	EH N ER
FIVE	F AY V
FORWARD	F AO R W ER D
FOUR	F AO R
FRIZZY	F R IH Z IY
GO	G OW
GREEN	G R IY N
HBO	HH B OW
INPUT	IH N P UH T
IS	IH Z
IT	IH T
LEFT	L EH F T
LIGHTS	L AY T S
MENU	M EH N Y UW
MTV	EH M T IY V
MUTE	M Y UW T
NEGATIVE	N EH G AH T IH V
NINE	N AY N
OFF	AO F
ON	AA N
ON(2)	AO N
ONE	W AH N
ONE(2)	HH W AH N
PAUSE	P AO Z
PLAY	P L EY
POWER	P AW ER
RECALL	R IY K AO L
RECALL(2)	R IH K AO L
RED	R EH D
RIGHT	R AY T
SCARLETT	S K AA R L IH T
SELECT	S AH L EH K T
SEVEN	S EH V AH N
SEXY	S EH K S IY
SIX	S IH K S
STOP	S T AA P
THE	DH AH
THE(2)	DH IY
THREE	TH R IY
TIME	T AY M
TO	T UW
TO(2)	T IH
TO(3)	T AH
TOSHIBA	T OW SH IY B AH
TURN	T ER N
TV	T IY V IY
TV(2)	T EH L AH V IH ZH AH N
TWO	T UW
UP	AH P
VOLUME	V AA L Y UW M
WEATHER	W EH DH ER
WHAT	W AH T
WHAT(2)	HH W AH T
WHATS	W AH T S
WHATS(2)	HH W AH T S
WHITE	W AY T
WHITE(2)	HH W AY T
ZERO	Z IH R OW
ZERO(2)	Z IY R OW
