BLUE	B L UW
CHANGE	CH EY N JH
GREEN	G R IY N
HBO	HH B OW
IS	IH Z
IT	IH T
LIGHTS	L AY T S
MTV	EH M T IY V
OFF	AO F
ON	AA N
ON(2)	AO N
RED	R EH D
SCARLETT	S K AA R L IH T
THE	DH AH
THE(2)	DH IY
TIME	T AY M
TO	T UW
TO(2)	T IH
TO(3)	T AH
TURN	T ER N
TV	T IY V IY
TV(2)	T EH L AH V IH ZH AH N
WEATHER	W EH DH ER
WHAT	W AH T
WHAT(2)	HH W AH T
WHATS	W AH T S
WHATS(2)	HH W AH T S
